ATT	I	Isoleucine
ATC	I	Isoleucine
ATA	I	Isoleucine
CTT	L	Leucine
CTC	L	Leucine
CTA	L	Leucine
CTG	L	Leucine
TTA	L	Leucine
TTG	L	Leucine
GTT	V	Valine
GTC	V	Valine
GTA	V	Valine
GTG	V	Valine
TTT	F	Phenylalanine
TTC	F	Phenylalanine
ATG	M	Methionine
TGT	C	Cysteine
TGC	C	Cysteine
GCT	A	Alanine
GCC	A	Alanine
GCA	A	Alanine
GCG	A	Alanine
GGT	G	Glycine
GGC	G	Glycine
GGA	G	Glycine
GGG	G	Glycine
CCT	P	Proline
CCC	P	Proline
CCA	P	Proline
CCG	P	Proline
ACT	T	Threonine
ACC	T	Threonine
ACA	T	Threonine
ACG	T	Threonine
TCT	S	Serine
TCC	S	Serine
TCA	S	Serine
TCG	S	Serine
AGT	S	Serine
AGC	S	Serine
TAT	Y	Tyrosine
TAC	Y	Tyrosine
TGG	W	Tryptophan
CAA	Q	Glutamine
CAG	Q	Glutamine
AAT	N	Asparagine
AAC	N	Asparagine
CAT	H	Histidine
CAC	H	Histidine
GAA	E	Glutamic
GAG	E	Glutamic
GAT	D	Aspartic
GAC	D	Aspartic
AAA	K	Lysine
AAG	K	Lysine
CGT	R	Arginine
CGC	R	Arginine
CGA	R	Arginine
CGG	R	Arginine
AGA	R	Arginine
AGG	R	Arginine
TAA	*	Stop
TAG	*	Stop
TGA	*	Stop
